{
  "level1":
  {
    "map":[
            [3,   4,  4,  4,  4,  4,  4,  4,  4,  4,  4,  4,  4,  4,  4,  4,  4,  4,  4,  5],
            [10,  2,  0,  0,  0,  0,  0,  0,  0,  0,  0,  0,  0,  0,  0,  0,  0,  0,  0,  6],
            [10,  0,  0,  0,  0,  0,  0,  0,  0,  0,  0,  0,  0,  0,  0,  0,  0,  0,  0,  6],
            [10,  0,  0,  0,  0,  0,  0,  0,  0,  0,  0,  0,  0,  0,  0,  0,  0,  0,  0,  6],
            [10,  0,  0,  0,  0,  0,  0,  0,  0,  0,  0,  0,  0,  0,  0,  0,  0,  0,  0,  6],
            [10,  0,  0,  0,  0,  0,  0,  0,  0,  0,  0,  0,  0,  0,  0,  0,  0,  0,  0,  6],
            [10,  0,  0,  0,  0,  0,  0,  0, 16, 15, 15, 17,  0,  0,  0,  0,  0,  0, 19,  6],
            [10,  0,  0,  0,  0,  0, 23, 16, 14, 14, 14, 14, 17, 25,  0,  0, 27,  0, 18,  6],
            [10, 20, 20, 20, 21, 20, 22, 20, 20, 20, 20, 20, 20, 24, 20, 20, 26, 20, 20,  6],
            [10,  0,  0,  0,  0,  0,  0,  0,  0,  0,  0,  0,  0,  0,  0,  0,  0,  0,  0,  6],
            [10,  0,  0,  0,  0,  0,  0,  0,  0,  0,  0,  0,  0,  0,  0,  0,  0,  0,  0,  6],
            [9,   8,  8,  8,  8,  8,  8,  8,  8,  8,  8,  8,  8,  8,  8,  8,  8,  8,  8,  7]
    ],

    "startPos":
    {
      "shirley":[100,330],
      "shaun":[180,340],
      "timmy":[60, 356]
    },

    "next": "level2"

  },

  "level2":
  {
    "map":[
            [3,   4,  4,  4,  4,  4,  4,  4,  4,  4,  4,  4,  4,  4,  4,  4,  4,  4,  4,  5],
            [10,  2,  0,  0,  0,  0,  0,  0,  0,  0,  0,  0,  0,  0,  0,  0,  0,  0,  0,  6],
            [10,  0,  0,  0,  0,  0,  0,  0,  0,  0,  0,  0,  0,  0,  0,  0,  0,  0,  0,  6],
            [10,  0,  0,  0,  0,  0,  0,  0,  0,  0,  0,  0,  0,  0,  0,  0,  0,  0,  0,  6],
            [10,  0,  0,  0,  0,  0,  0,  0, 16, 17,  0,  0,  0,  0,  0,  0,  0,  0,  0,  6],
            [10,  0,  0,  0,  0,  0,  0,  0, 16, 17,  0, 16, 15, 15, 17,  0,  0,  0,  0,  6],
            [10,  0,  0,  0,  0, 16, 14, 14, 14, 17,  0, 16, 14, 14, 17,  0,  0,  0, 19,  6],
            [10,  0,  0,  0,  0,  0, 23,  0,  0,  0,  0,  0,  0, 25,  0,  0, 27,  0, 18,  6],
            [10, 20, 20, 20, 21, 20, 22, 20, 20, 20, 20, 20, 20, 24, 20, 20, 26, 20, 20,  6],
            [10,  0,  0,  0,  0,  0,  0,  0,  0,  0,  0,  0,  0,  0,  0,  0,  0,  0,  0,  6],
            [10,  0,  0,  0,  0,  0,  0,  0,  0,  0,  0,  0,  0,  0,  0,  0,  0,  0,  0,  6],
            [9,   8,  8,  8,  8,  8,  8,  8,  8,  8,  8,  8,  8,  8,  8,  8,  8,  8,  8,  7]
    ],

    "startPos":
    {
      "shirley":[100,330],
      "shaun":[180,340],
      "timmy":[60, 365]
    },

    "next":"level3"

  },

  "level3":
  {
    "map":[
            [3,   4,  4,  4,  4,  4,  4,  4,  4,  4,  4,  4,  4,  4,  4,  4,  4,  4,  4,  5],
            [10,  2,  0,  0,  0,  0,  0,  0,  0,  0,  0,  0,  0,  0,  0,  0,  0,  0,  0,  6],
            [10,  0,  0,  0,  0,  0,  0,  0,  0,  0,  0, 11, 12, 12, 13,  0,  0,  0,  0,  6],
            [10,  0, 29,  0,  0,  0,  0,  0,  0,  0,  0,  0,  0,  0,  0,  0,  0,  0,  0,  6],
            [10,  0, 30,  0,  0,  0,  0,  0, 16, 17,  0,  0,  0,  0,  0,  0,  0,  0,  0,  6],
            [10,  0, 30,  0,  0,  0,  0,  0,  0,  0,  0, 16, 15, 15, 17,  0,  0,  0,  0,  6],
            [10,  0, 31,  0,  0, 16, 14, 14, 17,  0,  0, 16, 14, 14, 17,  0,  0,  0, 19,  6],
            [10,  0,  0,  0, 25,  0, 23,  0,  0,  0, 16, 14, 17,  0,  0,  0, 27,  0, 18,  6],
            [10, 20, 20, 20, 24, 20, 22, 20, 20, 20, 20, 20, 20, 21, 20, 20, 26, 20, 20,  6],
            [10,  0,  0,  0,  0,  0,  0,  0,  0,  0,  0,  0,  0,  0,  0,  0,  0,  0,  0,  6],
            [10,  0,  0,  0,  0,  0,  0,  0,  0,  0,  0,  0,  0,  0,  0,  0,  0,  0,  0,  6],
            [9,   8,  8,  8,  8,  8,  8,  8,  8,  8,  8,  8,  8,  8,  8,  8,  8,  8,  8,  7]

    ],

    "startPos":
    {
      "shirley":[100,330],
      "shaun":[180,340],
      "timmy":[60, 365]
    },

    "next": "none"

  }

}
